 - - - - - - - - - - - - - - - -
|             |   |   | | | | | |
   - - -         -   -
|   |     | | | |       |   |   |
 - -   - -         -   - - - -    
|             | |   |     |   | |
 - -   - -       -     -   
|           | | |   |     | | | |
   -   - - -       -   - 
| | | | | | | | |   |     | | | |
                 -   - -        
|             | |   |   |   |   |
                   -         - -       
| | | | | | | | |   | | | |     | 
                 -         -   - 
| |           |       |         |
  ---   | | --  | ----|    -   -|
|     | | |   | | |         | | |
   - -       - - - - -  - - -   
| |     | |                 |   |
   - -       - - - - - - - -     
|     |   | |         |       | |
 - -     -     -   - -   - - -   
|   | | |   | | | |     |       |
           -       - -     - -   
| |   | | |   | | |     | |   | |
 - -         -       - -         
|   | | | | |   | | |     | |   |
         -         -   - -       
| | |       | | |     |     | | |
     - - - -     - - - -     -   
| |           |           |   | |
 - - - - - - - - - - - - - - - -
